11111111111111
1000000PCE0001
11111111111111
