1111111111111111111111111111
100000E000C000000CEP00000001
1000E000C00P0000000000000001
100E000000P00P00P00000000001
11110000C0001111111110000001
1111110000CC0000000000011011
1111111111111111111111111111
