11111111111111111111111
10000000000000000000011
11111111CCCC00000000111
111111P0000000000000001
1111111E000000000000001
11111111111111111111111
