11111111111111111111111111111111111111111111111111111111111111111111111111111111111111111111111111111
10000000000000000000000000000000000E0000010000000C0000000000000000000000000000000E0000000000000000001
11111111111111111111111000000000000000000P00000000000000000000000000111111111111111110000000000011111
1111111111111100000000000000C000000000000001111111100000000000000101000000000000000000000000001111111
111111000000000000000000C1110000001111111111111000000000000111111111111111111111111110000000000000011
11111111111111111000000000001111111111101111111111001111111111111111111111111111111110000000000111111
10000000100000000000000111111111000000000000000000000000000000000111110000111110000000000000000111101
111111111000000000000000000000000C1111111111111111000011111111111111111111111111111111111111111111111
11000000000000000111000000000000000000000000000C000000000000000E0000000000111100000000000000000000011
11111111100000000001111111111111100000001111111111100111100000000000001111000000000000000000000111111
1111111111110C0000000001111111111111111111111EC111111110000000000000000000000000000000000001111111111
11110000000000111111111111111111111110000000000111111111111111111111111111111111111111111111111111111
11100000000000000000000000000000000000000000000000000000000000000000000000000000000000000000000000011
11111111111111111111111111111111111111111111111111111111111111111111111111111111111111111111111111111
